Acidiphilium_cryptum_JF-5	AC
Alphaproteobacteria_bacterium_RIFCSPLOWO2_01_FULL_40_26	ABRI
Anaplasma_centrale_str._Israel	AC
Anaplasma_marginale_str._Florida	AM
Anaplasma_phagocytophilum_str._HZ	AP
Azospirillum_brasilense_Sp245	AB
Bin_135	B135
Bin_49	B49
Bin_69_133	B69
Bin_84	B84
BIN125-1	B125
BIN67-1	B671
BIN67-3	B673
Candidatus_Arcanobacter_lacustris	CAL
Candidatus_Jidaibacter_acanthamoeba	CJA
Candidatus_Midichloria_mitochondrii_IricVA	CMM
Candidatus_Neoehrlichia_lotoris_str._RAC413	CNL
Candidatus_Odyssella_thessalonicensis	COT
Candidatus_Puniceispirillum_marinum_IMCC1322	CPM
Candidatus_Xenolissoclinum_pacificiensis_L6	CX
Caulobacter_crescentus_CB15	CC
Ehrlichia_canis_str._Jake	ECJ
Ehrlichia_chaffeensis_str._Arkansas	ECA
Ehrlichia_ruminantium_str._Gardel	ER
endosymbiont_of_Acanthamoeba_sp._UWC8	EA
Neorickettsia_helminthoeca_str._Oregon	NH
Neorickettsia_risticii_str._Illinois	NR
Neorickettsia_sennetsu_str._Miyayama	NS
Orientia_tsutsugamushi_str._Ikeda	OT
Rhizobium_etli_CFN_42	RE
Rhodobacter_sphaeroides_2.4.1	RS
Rhodospirillum_rubrum_ATCC_11170	RR
Rickettsia_bellii_RML369-C	RB
Rickettsia_felis_URRWXCal2	RF
Rickettsia_prowazekii_str._Madrid_E	RP
Rickettsia_rickettsii_str.__Sheila_Smith_	RRSS
Rickettsiaceae_bacterium_Os18	RBOS
Rickettsiales_bacterium_Ac37b	RBAC
Wolbachia_endosymbiont_of_Culex_quinquefasciatus_Pel	WECQ
Wolbachia_endosymbiont_of_Drosophila_melanogaster	WEDM
Wolbachia_endosymbiont_of_Onchocerca_ochengi	WEOO
Wolbachia_endosymbiont_strain_TRS_of_Brugia_malayi	WEBM
Zymomonas_mobilis_subsp._mobilis_ATCC_10988	ZM
